1111111111111111111111111111111111111111
1454545154545454545454545454545454545451
1222200110000000000000000000444500111111
1222200110011100032222222000544400111111
1222200110011100032220000000454500111111
1220000110011100033222000002254540001111
1222000700011400022222222200000002111111
1222000110011100000000000000000012211111
1222000110042200000003333300000011001111
1222200110042200110003000333300012001111
1222200110000700330003000000700021000111
1222200070052200330003333333300022200001
1222200610012200330000000003300000000001
1222000610021100220002222003312120000441
1220000610011100000002222003311220000411
1200000110000000000000000000000000004411
1200033333333330011111111171111110004411
1200066666666660011114111101111117114411
1200000000053330011000000000000000011411
1200333033333330041002222222222220011111
1200333733333330011002222222222220001111
1200330000000330011002200000022220001111
1200330044400330007007200550022220001111
1200330044400330011002200550020000001111
1200000044400330041002200000000022000011
1171111000002220011112222227222222000061
1101111002272220000000000000000000006111
1101100002200000000033333300000000061111
1101100222000055500033300222220000611111
1101100225000055500033300222220000611111
1101171112200055500033400222220000611111
1171100112200007000033300000000000611111
4000000000000055500033433337440000611111
1000666666660005000070005330440001111111
4000222242220005000110004330000001116661
1000200000000022200110005330001141160061
1000700001100023300110003330001166660061
4000200005100033300110003330007000000061
1000200001100033300070000000001100000061
1141111111111111111111111111111166666611
